SFFFFFFFFFFFFFFF
FFFFFFFFFFFFFFFF
FFFFFFFFFHFFFFHF
FFFFFFHFFFFFFFFF
FFFFFFFFFFFFFFFF
FFFFFFFFFFHFFHFF
FFFFFFFFFFFFHFFF
FFFFFFHFFFFFFFHF
FFFFFFFFFFHFFFFF
FFFFFFFFFHFFHFHF
FFFFFFFFFFFFFFFF
FFFFFFFFFHFFFFFF
FFFFFFFFFFFFFFFH
FFFFFFFFFFFFFFFF
HFFFFFFFFFFFFFFF
HFFFFFFFFFFFFFFG