SFFFFFFFFFFFFFFF
FFFFFFFFFFHFFFFF
FFFFFFFFFFFFFFFF
FFFFFHFFFFFFFHFF
FHFFFFFFFFFFFFFF
FFFFFFFFFHFFFFFF
FFFFFFFFFFFFFFFF
FFFFFHFFFFFHFFFF
FFFFFFFFFFFFFFFF
FFFFFFFFFFFFFFFF
FFFFFHFFFFFFFFFF
FHFFFFHHFFFFFFFF
FFFFFFFFFFFFFFFF
HFFFFFFFFFFFHFFF
FHFFFFFFFFFFFFFF
FFFFFFFFFFFFFFFG