SFHFFFFFFFFFFFFF
FFFFFFFFFFFFFFFF
FFFFFFFFFFFFFFFF
FFFFFFFFFFFFFFFF
FFFFFFFFFFFFFFFF
FFFFFFHFFFFFFFFH
FFFFFFFFFFFFFFFF
FFFFFFFFFFFFHFFF
FFFFFFFFFFFFFFFF
FFFHFFFHFFFFFFFF
FFFFFFFFFFFHFFFF
HFFFFFFFFFFFHFFF
FFFFFFFFFFFFFHFF
FFFFFFFFFFFFFFFF
FFFFFFFFFFFFFFFF
FFFFFFFFFHFFHFFG